##############
#Icccccccc---#
#########c---#
#-#Occcccc#--#
#-#########--#
#------------#
##############