#####################
#-------------------#
#------######-------#
#-----I#    #-------#
########    ##------#
            #---#---#
            #-------#
            #-------#
#############-----#-#
#-----------#-------#
#--O------------##--#
#--------###--------#
##################### 