########
#-----I#
#-######
#------#
######-#
#O-----#
########