#####################
#-----ccccccccc-----#
#-----c######-c-----#
#-----I#    #-c-----#
########    ##c-----#
            #-c-#---#
            #-c-----#
            #-c-----#
#############-c---#-#
#-----------#-c-----#
#--Occccccccccc-##--#
#--------###--------#
##################### 