##############
#I-----------#
#########----#
#-#O------#--#
#-#########--#
#------------#
##############