#####
###O#
###-#
###-#
#I--#
#####