#;#;#;#;#;
#;#;#;O;#;
#;#;#;-;#;
#;#;#;-;#;
#;I;-;-;#;
#;#;#;#;#;